111111111
111131111
111131111
111131111
112121111
112212111
113232111
333232111
332231111
233111111
131111111