111101111
111131111
111131111
111131111
111121111
111222111
111232111
111232111
111131111
111111111
111111111